0000000000000000000000000000000000000000
0000000000000000000000000000000000000000
0000000000000000000000000000000000000000
0000000000000000000000000000000000000000
0000000000000000000000000000000000000000
0000000000000000000000000000000000000000
0000000000000000000000000000000000000000
0000000111111110000000000000000000000000
0000000111111110000000000000000000000000
0000000111111110000000000000000000000000
0000000111111110000000000000000000000000
0000000111111110000000000000000000000000
0000000111111110000000000000000000000000
0000000111111111000000000000000000000000
0000001111111111000000000000000000000000
0000001111111111000000000000000000000000
0000111111111110000000000000000000000000
0000111111111111100000000000000000000000
1111111111111111111111110000000000000000
1111111111111111111111111000000000000000
1111111111111111111111111100000000000000
1111111111111111111111111110000000000000
1111111111111111111111111111000000000000
1111111111111111111111111111100000000000
1111111111111111111111111111111000000000
1111111111111111111111111111111100000000
1111111111111111111111111111111111000000
1111111111111111111111111111111111100000
1111111111111111111111111111111111100000
1111111111111111111111111111111111110000